yàlla: yalla yala yàla
xool: khool
xol: khol
senegaal: sénégal senegal
ndakaaru: dakar
mbaam: mbam
xaar: khare
xar: khar kharr
ñu: gnou niou
suñu: sunu souniou sougnou
ngeen: nguen
beneen: benene
yoonu: yonou yoonou
ndeysaan: ndeyssane ndeysan ndeysane ndeyssan
ñi: gni
yërmande: yeurmandè yeurmande
gëj: guedj gueudj geudj
dëkk: deuk deukk
dama: deuma dam
yaakaar: yakar yaakar yakaar
xadiis: khadis khadiis qadiis xadis
réew: réw rew
dañu: deniou daniou
génn: guene guen genn
mbedd: med mbed mbéd
forox: forokh
caaya: thiaya
bëgg: beug beugg beugue
laaj: ladj laadj laj
ci: tchi tchie thie
kër: keur keurr kërr
bu: bou
xale: khale khalé xalé
lépp: lepp lep lép
xaalis: khalis khaalis xaliis xalis
seriñ: serign serigne
bari: bary
bes: bess
delloo: delo deloo dello
tànk: tank
kan: kane
nelaw: nélaw
wax: wah wakh
seen: sene
dafay: dafaay
lammiñ: lamigne lamign
këpp: keupp keup këp
xamul: khamoul khamoule xamoul xamoule
neex: nekh neekh neikh
sañ: sagn
gën: gueune gueun
dóor: dore door
xorom: khorom khorome
benn: ben bene
yépp: yeup yepp yeupp yep yepp
nekk: nek
jullit: dioulit dioullit
julli: diouli dioulli
bawol: baol
ñooro: nioro
bàkkel: bakel
bàmbara: bambara
bànjul: banjul
baambey: bambey
kayor: cayor
waalo: walo
aréen: arene
asaka: azaka
aspirin: aspirine
asamaan: asamaane asamane asaman
àggale: aggale
àbb: abb
àll: ale
àddu: addou àdu
àgg: agg
àllarba: allarba alarba àlarba
àlluwa: àllouwa àlouwa alouwa allouwa
ànd: and
àllaaxira: alaxira alakhira àllaxira àllaakhira àlaaxira allakhira àlakhira àlaakhira
àjjuma: adiouma ajuma àjuma
àjjana: adiana aljana ajana àjana ajjana
alxemes: alkhames alkhemes alxames
alxuraan: alkhourane alkhouran alxuraane alxuran alxurane
alamaan: alamaane
àndadoo: andado andadoo àndado
àntu: antou antu
àppal: appal
àtte: até atté atte ate àte
àttaaya: ataya attaya ataaya attaaya àtaya àttaya
amal: amale
añ: agn agne
ameel: amél amel
amiin: amine amin
armeel: armel armél
àddina: adina addina àdina
àdduna: adouna addouna aduna àddouna àdouna
ax: akh
ayca: aythia aytcha
aawo: awo
aajo: adio ajo adjo
aaya: aya ayat aayat
ñaar: gnaar gnar niar niaar
astafurlaa: astafurlah astafurlaah astafourlah astafourlaah astafurla astafourla astafourlaa
bànneex: bannekh banekh bàneex banneekh
baadoola: badola baadola badoola
baadoolo: badolo baadolo badoolo
bàmba: bamba
bañ: bagn bagne
baña: bagna
bant: bante
barsàq: barsakh barsàkh
baram: barame
batañse: batagnse batagnsa
baxal: bakhal
bàjjan: badiane badian badjane badjan bajjan
bàjjen: badiene badien badjene badjen bajjen
baxaw: bakhaw
bàcc: bathie bathieu batchie batchieu batch bath
bàmmeel: bamel bameel bammel bammeel bàmel bàmeel bàmmel
bàyyima: bayyima bayima bàyima
bàyyi: bayi bayyi bàyi
baamtu: bamtu
baamu: bamu
baax: bakh
baaraam: baram baaram baraam barame baarame baraame
bég: beg begg
béjjén: bedieun bedjen bedjen bédjen bédjeun béjén
bépp: bepp bep
bëmëx: bamakh beumeukh boumakh boumeukh bëmëkh
bëñ: beugn begn bëgn
bëccëg: bëcëg beuthieug beutchieug beuthieuk beutchieuk
bëre: beure beuré

bóom: boom bom
buur: bur
buux: boukh
caga: thiaga tchiaga
caw: thiaw
cat: thiat thiatt
cant: thiant thiante tchiant tchiante
capp: thiap thiapp
carax: thiarakh thiarakhe
cofeel: thiofel thioffel tchiofel
ceeb: thiép tchiep thiep tiéb thieb tchieb
coroxaan: thiorokhan
coof: thiof tchiof
coppati: thiopati thioppati tchiopati
coow: thiow tchiow
coqtaan: thiokotane thiokhotane tchiokotane tchiokhotane thiokotan thiokhotan tchiokotan tchiokhotan
cuuraay: thiouray tchiouray thiouraye tchiouraye
jaay: diay
dajale: dadiale
dellusi: delousi
dégg: deg degg
dëpp: deup deupp
doxantu: dokhantou
doxaan: dokhane
dukkat: dukat
duruus: drouss
doxat: dokhat dokhate
doxal: dokhale dokhal
doom: dom
door: dor
dund: dound
dunde: dounde
dundal: doundal doundale
dunq: dounkh
ëf: euf euff
ëfël: euffeul eufeul
ëpp: eup
ëppal: euppal eupal
ërtël: kheurteul heurteul
ëmb: eumb
ëmbal: eumbal eumbale
fanaan: fanane fanan
fajar: fadiar fadiare
fakkastalu: fakastalu
farmasi: pharmacie
cosaan: thiossan thiossane
cokk: thiokh
faxas: fakhas fakhass
faale: fale
fàttaliku: fattéliku fatteliku
fettax: fettakh fetakh
fexe: fekhe
feyyu: fayu fayyu
feebar: fébar febar
fëgg: feug feugg
féey: féy fey
fobeere: fobere
fuuta: fouta
cees: thies thiès
fuqle: fokhale foukhale fokale foukale
fóon: fone fon foon
fukk: fouk foukk
fulla: foula foulla
futti: fouti foutti
fuddën: foudeun fouddeun
futbal: football futball
gajj: gadj gadji
galaxndiku: galakhndikou galakhndiku
gàcce: gacce gace gathié gatchié
gàllankoor: gallankoor gallankor galankor galankoor gàlankoor gàlankor
gàllaaj: galadj galladj gàladj gàlladj
gàddaay: gaday gadday gadaay
gàmmu: gamou gamu gammou
gàddu: gaddou gadou





















































































































































